1111111111111111111111111111111111111111
1000010000000000000000001000000000000001
1000010000000000000000001000000000000001
1000010001111111111111111000000000000001
1000010000000000000000001000000000000001
1000010000000000000000001111100000000001
1000000000000000000000001111100000000001
1111111111111110000000000000000000000001
1000000100000000000000000000000000000001
1000000100000000000000001100000000000001
1000000100000001100000001100000000000001
1000000100000001100000001100000000000001
1000000100000000000000001100000000000001
1000000000000000000000001100000000000001
1111111111111111111111111111111111111111