11111111111111111111
10000100000000000001
10000100000000000001
10000100000000000001
10000100000000000001
10000100000000000001
10000000000000000001
10001111111111100001
10000000000000000001
10000000000000000001
10000000000000000001
10000000000000000001
10000000000000000001
10000000000000000001
11111111111111111111