1111111111111111111111111111111111111111
1000010000000000000000001000000000000001
1000010000000000000000001000000000000001
1000010000000000000000001000000000000001
1000010000000000000000001000000000000001
1000010000000000000000001000000000000001
1000000000000000000000001000000000000001
1000111111111110000000000000000000000001
1000000000000000000000000000000000000001
1000000000000000000000000000000000000001
1000000000000000000000000000000000000001
1000000000000000000000000000000000000001
1000000000000000000000000000000000000001
1000000000000000000000000000000000000001
1111111111111111111111111111111111111111